Muy buenos días, bienvenidos a **Modo Fontevecchia**. En este **viernes** llegamos al viernes, promediando las vacaciones de invierno, por lo menos aquí en la ciudad de Buenos Aires y la provincia de Buenos Aires. Un viernes muy especial, con mucha, pero mucha información, porque ha pasado absolutamente de todo durante esta semana y especialmente en las últimas horas. Así que aquí estaremos en Modo Fontevecchia como todos los días hasta las 12 del mediodía para hacerles compañía con todo el equipo, por supuesto, de Modo Fontevecchia. Saludamos ya mismo a **Elizabeth Pesci**. Buen día, Eli. Muy buenos días, Ale. Muy buenos días para todos. Linda temperatura para un viernes. Supuestamente va a llover mañana, pero hoy arrancamos bien, 11 grados, así que a disfrutar de una jornada menos fría que las últimas semanas. Aflojó un poquito el frío de los últimos días. Se viene el fin de semana con lluvia y donde no hace nada de frío, sino que hace calor. Un calor bárbaro. Subió mucho la temperatura, es la política, las cosas que están sucediendo en las últimas horas, casi impensadas hace algún tiempo. Primero, bueno, el estilo Milei, que cada vez se profundiza más. ¿Qué decimos del estilo Milei? El enfrentamiento, la confrontación, como modo de relacionarse, bueno, casi en la vida, de **Javier Milei**. También en la política, y que lleva a esta canción que escuchábamos al comienzo de Modo Fontevecchia, que habla de la traición, porque, ahora la vamos a desarrollar, habló de traición. Javier Milei habló de traición cuando hablaba esta mañana a través de los tweets que dio y que habló de **Despotorno** especialmente y de **Teddy Karagosian**, que fueron los dos últimos que se fueron, que se fueron del gobierno, que fueron despedidos del gobierno, igual que **Garro** en la Secretaría de Deportes. Pero el dato político que más impactó en las últimas horas fue la decisión de **Karina Milei**, la hermana de Milei, la Secretaria General y Técnica de la Presidencia, Secretaria General de la Presidencia, pero además la otra persona fuerte, casi como el presidente bis que tiene la Argentina, que es Karina Milei, ir personalmente hacia la Embajada de Francia y pedir disculpas. ¿Por qué pide disculpas? ¿Por algo que hizo ella? No. Por las declaraciones que hizo la vicepresidenta, **Victoria Villarruel**. Y realmente es un dato y una imagen impactante. Y el propio gobierno, él lo dio a conocer a través de sus voceros oficiales y oficiosos, dejó trascender esto, que había ido Karina Milei allí. ¿Por qué? Porque en Francia había comenzado a crecer, y fuerte, lo que fueron las declaraciones, los tweets de la vicepresidenta en contra de Francia, hablando de un país colonialista. Y cuando falta muy poquito para que Milei viaje a Francia, para que tenga una reunión con Macron, que vaya a la inauguración de los Juegos Olímpicos. A desactivar eso fue Karina Milei, a tirarse arriba de la bomba, antes que crezca un conflicto diplomático con Francia. Pero esto tiene, por supuesto, antecedentes. Nunca se llevaron bien Karina Milei y Victoria Villarruel. Nunca se llevaron bien. Y hay algunas declaraciones, recordamos cómo definía en su momento Victoria Villarruel la relación de ella con Javier Milei y con Karina. Esta idea de que Javier Milei era el jamoncito del sándwich. Claro, exacto. Una relación que no es buena desde la campaña. Pero hay una diferencia. Victoria Villarruel fue electa. No la puede **echar** del gobierno. No tiene otra posibilidad que convivir con ella. La única entrevista que dio Victoria Villarruel habló sobre su relación con Karina Milei. ¿Qué decía Victoria Villarruel de su relación con Karina Milei con el presidente de en medio? Karina, ¿cómo te llevas? Karina tiene mucho carácter, pero yo también. Las dos queremos a Javier y las dos queremos lo mejor para Javier. En distintos ámbitos de la vida. Pero yo ya sé eso. Es brava, pero nos llevamos bien. Y vos sos brava también. Sí. Brava contra brava, brava al cuadrado. Sí, exacto. Somos parecidas en algunas cosas y en otras no. Viste que dicen polo positivo más polo positivo es bolonqui. Y bueno, en el medio está Javier. Pobre jamoncito. Pobre jamoncito. No, pobre jamoncito decía Victoria Villarruel y le estallaba la carcajada. Algo que, por supuesto, no cayó nada bien en Casa Rosada. Hasta aquí, por lo menos hasta lo que sucedió ayer, había una convivencia educada. Y en Casa Rosada respetan el papel que tiene Victoria Villarruel como presidenta del Senado. A partir de aquí, cómo sigue esta relación entre presidencia y vicepresidencia en la Argentina. Tenemos tantos antecedentes. Pero hay un tema también de fondo que se trasluce en la discusión con Francia. Que desde las posturas ideológicas no son lo mismo. De hecho, son bastante distintas. La que tiene el presidente Javier Milei y la que tiene la vicepresidenta Victoria Villarruel. Lo explicaba aquí en un modo Fontevecchia un viernes **Gustavo González**. En cuanto al nacionalismo de Victoria Villarruel. Más clásico, más representante de lo que en un momento fue el partido militar. Y el anarquismo, anarco-liberalismo de Milei. Que no cree en el estado de nación, sino en la libertad de las corporaciones. Allí hay un choque ideológico importante dentro de estos dos representantes de la derecha en la Argentina. Aquí aparecen las diferencias aquí. Cuando se habla de colonialismo, de patriotismo. Y cómo hay que pararse frente a algunas cuestiones. ¿De dónde vino todo esto? Todo esto empezó increíblemente por el fútbol. Había empezado por un cantito de fútbol. Exactamente. A partir del canto que... A ver, la selección argentina después de convertirse en el campeonato de la Copa América. El jugador **Enzo Fernández** publicó un vivo de Instagram. Donde aparecen algunos jugadores cantando un tema que suelen cantar hinchadas argentinas. Y bueno, esto tomó... Si bien rápidamente los jugadores se dieron cuenta que había hecho un error y suspendieron esa transmisión. Esto generó muchísima repercusión. En el ámbito futbolístico y llamativamente se trasladó a la política. Exacto. Bueno, el canto para los que están distraídos. La parte más suave dice: "Escuchen, corran la bola. Juegan en Francia, pero son todos de Angola". Esa es la parte que se puede decir públicamente. Imaginen lo que es el resto de la canción. Una canción tremenda, tremenda. Racista, homofóbica, la tiene todas. Y la cantaban en un vivo. Y aparecía la carita de Enzo Fernández. Además, que era quien estaba haciendo la transmisión. Y por eso, además, pensando que Enzo Fernández juega en el Chelsea, en un equipo de la Premier League. Donde comparte sus tareas diariamente con varios jugadores de la selección francesa. Y bueno, enseguida esto generó repercusión. En el ámbito futbolístico, pero lo llamativo. Claro. Es que de inmediato la política se hace eco de esto. A partir de los comentarios que hace **Julio Garro**, el subsecretario de deportes que, además, es un hombre del Pro. Un hombre muy cercano a **Mauricio Macri**. Que abre otra ventana con la pelea que tuvieron ahí. Absolutamente. Pero, exacto. Le preguntan a Garro en una entrevista qué opinaba de lo que había sucedido. Enzo Fernández ya había pedido disculpas. De hecho. Y Garro sube la apuesta. Dice, bueno, me parece que también tendría que pedir disculpas a Messi y al resto de la selección. Pero vamos a verlo. Julio Garro, el ahora ex número dos de la Secretaría de Deportes. Un poco comparto de lo personal. Lo que comentaba hace un rato. Creo que el capitán de la selección. Debe salir también a pedir las disculpas de ese caso. Lo mismo que el presidente de la AFA. Creo que corresponde. Y coincido con vos. Es algo que nos deja como país mal parado. Con tanta gloria. Pero bueno. Y esto de poder llevar ese plano a algo ejemplificativo. Creo que también es muy bueno. Y se hace mucho en nuestro país y en el mundo. Bueno, estas declaraciones de Garro significaron el certificado de función como funcionario. Y además, me parece que muestra también. A ver, ¿por qué aparece la política? Fundamentalmente, el gobierno discutiendo sobre lo que pasó con los jugadores de la selección. Bueno, hay un interés, me parece, del gobierno de, de alguna manera, utilizar lo que fue el triunfo. Y aparte, la repercusión, la adhesión, el apoyo que genera en la sociedad. En la selección argentina. Bueno, después de ganar el mundial. Y además, ahora con la Copa América. Pero me parece que fue un uso extraño. Y que hizo escalar aún más el conflicto. En un momento en que al gobierno me parece que no le convenía. Y obviamente la reacción, me parece, del presidente Javier Milei. Quien inmediatamente decide renunciar a Garro. Tiene que ver también con esa intención de posicionarse como en la cercanía de la selección. Una selección que, además, le dijo que no a Milei en su propuesta para visitar la Casa Rosada. Para reunirse con el presidente. Habían hecho el intento de prestarle el balcón. Ni siquiera voy a estar, dijo Milei en Twitter, voy a estar en la Casa en Olivos. Y ustedes tienen el balcón. Y mediante redes sociales, mediante un tweet de lo que se llama oficina del presidente, que es como una especie de comunicados oficiales. Pero que son por tweet. De una manera extraña que tiene el gobierno de comunicar a través de tweet. Una cuenta de X que se llama oficina del presidente. Informan allí que Garro deja de ser subsecretario. Y lo retan diciendo que ningún gobierno puede decirle qué comentar o qué pensar. O qué hacer a la selección argentina. Y de esa forma, sobre la noche de ese mismo día donde Garro dio las declaraciones. Es eyectado el funcionario. Pero hubo varios que subieron a esto. Los satélites que tiene el gobierno que lo defienden. Y que por momentos parecen estar cerca de la mesa chica. Y que en realidad no están tan cerca. Van y vienen. Hay de estos personajes libertarios que están así pululando. Y en este caso es la diputada **Lilia Lemoine**. En la que habló del tema. Le preguntan por esto a Lilia Lemoine. Que a veces se la ve en Casa Rosada. ¿Sabes cuándo se la ve en Casa Rosada? Cuando Milei tiene algún acto o alguna entrevista. Y entonces ella va y se ocupa de maquillarlo. De hecho, cuando la última asunción que fue la de **Sturzenegger**, sale de la puerta por dentro del presidente hacia el salón blanco. Todavía con el... Yo digo la cartuchera. La cartuchera donde van los maquillajes. Exactamente. Un neceser. Neceser. Perdón. No estoy en el tema. Todavía abierto. Y dijimos: "Debe estar por venir el presidente". Y efectivamente, dos minutos después apareció el presidente. Pero bueno. Es diputada nacional. Le preguntaron por esto y desbarrancó así. Me parece fantástico que lo hayan echado. El presidente es un tipo que estaba rodillando feo. Se lo veía como estaba a punto de sobarle la quena a alguien. Yo no quiero un funcionario en el gobierno que vaya a chuparle nada a ninguna potencia extranjera. Porque los que vienen se dicen vienen de patria. Después les parece fenómeno que haya un funcionario diciendo: "No, los jugadores tienen que disculparse". Primero, ningún ciudadano argentino tiene que disculparse con nadie a pedido de un funcionario. Un individuo privado, nada que ver. Un individuo privado hace de su vida lo que quiere. Y si el individuo privado insulta o ofende a un individuo de otro país o otro país. Tendría que ver las consecuencias en particular. ¿Qué decir? Es diputada nacional. Se llama Lilia Lemoine y está sentada en una de las 272 bancas de la Cámara de Diputados. Y maquilla al presidente. Sí, por supuesto. Nadie le toca la cara al presidente si no es Lilia. Bueno, decíamos, ¿no? Victoria Villarruel, Karina Milei. Karina Milei saliendo disparada ayer a última hora de la tarde a la Embajada de Francia. A bajar la atención, a pedir disculpas. ¿Por qué pide disculpas la hermana del presidente? Bueno, por este tuit de la vicepresidenta, de Victoria Villarruel. Le pedimos a nuestro compañero, Elian López **Caucero**, que lo lea. ¿Qué decía o qué escribía Victoria Villarruel? Argentina es un país soberano y libre. Nunca tuvimos colonias ni ciudadanos de segunda. Nunca la impusimos a nadie en nuestra forma de vida. Pero tampoco vamos a tolerar que lo hagan con nosotros. Argentina se hizo con el sudor y el coraje de los indios, los europeos, los criollos y los negros como remedios del Valle. El sargento Cabral y Bernardo de Monteagudo. Ningún país colonialista nos va a amedrentar por una canción de cancha ni por decir las verdades que no se quieren admitir. Basta de simular la indignación, hipócritas. Enzo Llotevanco. Messi. Gracias por todo. Argentino siempre con la frente alta. Viva la argentinidad. Ahí está. Enzo Llotevanco. El mismo Enzo que era, Enzo Fernández, que había pedido disculpas. Y sobre todo la frase que hizo más ruido en Francia: "Ningún país colonialista", dice la vicepresidenta, "nos va a venir a amedrentar". Esto era el comienzo de un conflicto diplomático que sale cada vez a la **millería** a tratar de frenar antes que arranque. Exactamente. Y por eso en la visita ayer, ayer hubo un evento en la embajada de Francia que tenía que ver con todos los actos que se realizaron estos últimos días en el marco del Congreso Judío que se realizó en Buenos Aires. En el marco también del aniversario por los 30 años del ataque a la embajada de Israel. Y en este marco, Karina fue a este evento en la embajada de Francia y tuvo una reunión aparte con el embajador donde transmite este pedido de disculpas en nombre de su hermano Javier Milei. Y es ahí donde se coordina, se termina de confirmar entonces la visita que hacia fines de la semana próxima va a realizar el presidente a París. Donde, además de participar de la apertura de la fiesta inaugural de los Juegos Olímpicos, va a tener un encuentro, el primer encuentro oficial cara a cara con Emmanuel Macron. Y bueno, el gobierno quería de alguna manera, con este gesto de Karina, garantizarse que iba a tener una buena recepción y que ese encuentro con Macron. Y además, su visita, digamos, la popularidad de Milei en algunos países de Europa ha crecido significativamente en los últimos tiempos. No es alguien que por ahí pase desapercibido, su visita en el marco también de la apertura de los Juegos Olímpicos que también tienen que ver con el deporte. Y también va a haber una representación de la selección argentina de fútbol, no genere más ruidos de los que ya se habían generado hasta ahora. Pero bueno, todo esto entonces, en el contexto de una disputa cada vez más evidente entre Karina Milei y Victoria Villarruel, que son dos figuras claves y dos mujeres claves en el gobierno. Y a la hora de entrar a Francia con una declaración de tu vicepresidenta diciendo que es un país colonialista y Milei tener que entrar a un estadio a la inauguración de los Juegos Olímpicos con ese antecedente, corría el riesgo de ser abucheado por todo el estado, por los franceses que estén ahí. Por eso ahí se explica que Karina Milei ya haya ido ayer a la embajada. Y estas dos mujeres, bien lo decías, estas dos mujeres que se pelean, lo veíamos al comienzo en aquella declaración de la vicepresidenta, diciendo "pobres jamoncitos" porque estaban entre dos mujeres fuertes. Bueno, aquí la producción tiene un pequeño hallazgo de mujeres que se pelean. ¿Y de quién habla esto? ¿Luis Ventura? ¿Pensaron que iba a decir Luis **Panini** o algún analista político, **Verbitsky**? No. Vamos a hablar, a escucharlo a Luis Ventura cómo describe la pelea entre Karina Milei y Victoria Villarruel o entre **Moria Casán** y **Susana Giménez**. Bueno, ahí está, eh. Sonido grande. Sonido grande que molesta cuando los ojos son los ojos de enfrente. A ver, ellas no son amigas, como bien dijo Lucas, pero también es cierto que guardan secretos que ni imaginamos la una de la otra. Es como un partido hasta algún caballero en las primeras semillas. A tal punto que en determinado momento, en un living de Susana, hay un jueguito donde Susana se para para taparle la boca a Moria y Moria se levanta y la empieza a correr alrededor del sofá. Muy gracioso. Como diciendo: "No, eso no lo conté, no lo conté". Viven, viven, evidentemente no piensan lo mismo, tienen distintos discursos. Está buenísimo eso. Tienen patrimonios completamente diferentes entre uno y otro y tienen una actitud de declaración. Moria, se encuentra cómoda en ese, en ese boceo permanente de definir. Se encuentra cómoda e incomodando. Claro, exactamente. Bueno, cualquier parecido con lo que está sucediendo no es pura coincidencia. Pero el que mejor describía lo que sucedía, posiblemente estas mujeres, es Luis Ventura, hablando en este caso de Moria Casán y Susana Giménez. Pero las mujeres fuertes de carácter, como decía la vicepresidenta, que se están peleando, que esto es un peldaño más, pero que seguramente no va a quedar acá. Si fuera otro funcionario, obviamente ya estaría **echado**. Pero es la vicepresidenta y no la puede remover el presidente. Exacto. Ayer, Javier Milei, respecto de la salida de Garro, respecto de la salida de, vos lo mencionabas, Karagosian y Spotorno, del consejo de asesores, hablaba de traición. Bueno, parece que en algún sentido y también después de la multiplicación de posteos de algunos referentes o militantes de La Libertad Avanza, como por ejemplo, el **Gordo D'án**, que suele después repostear el propio presidente, se producen salidas de funcionarios por pensar distinto. Javier Milei lo define como traición. ¿Definida también como traición lo de Victoria Villarruel? Es una gran pregunta. Es una gran pregunta si es traición también lo de Victoria Villarruel. Por eso cerramos la apertura de Modo Fontevecchia, ¿cómo la abrimos? Con Miranda. Con traición. Y lo que está sucediendo, vaya novedad para la política argentina en la nueva pelea entre presidente y vicepresidenta.

**Cambios Realizados:**

*   **Corrección de nombres y apellidos:**
    *   Pescher --> Pesci
    *   Despotorno --> Despotorno
    *   Teddy Cagarossian --> Teddy Karagosian
    *   Garro --> Garro
    *   Villarroel --> Villarruel
    *   Enzo Fernández --> Enzo Fernández
    *   Julio Garros --> Julio Garro
    *   Lila Lemoyne --> Lilia Lemoine
    *   Elian López Caucero --> Elian López Caucero
    *   Llotevanco --> Fernandez
    *   Luis Pañi --> Luis Panini
    *   Verbisky --> Verbitsky
    *   Moria Kazan --> Moria Casán
    *   Susana Jiménez --> Susana Giménez
    *   Dán --> D'án
*   **Corrección de ortografía:**
    *   Fontedeccia --> Fontevecchia (consistente en todo el texto)
    *   viernes --> viernes (en el encabezado)
    *   ejectar --> echar
    *   enmedia --> en medio
    *   Milet --> Milei (consistente en todo el texto)
    *   aflojo --> aflojó
    *   brava al cuadrado --> brava al cuadrado
    *   pro --> Pro (nombre del partido)
    *   mileria --> millería
    *   echado --> echado
*   **Verificación de cohesión y coherencia:**
    *   Se corrigieron algunas repeticiones innecesarias de palabras.
    *   Se ajustaron algunas frases para mejorar la fluidez del texto.
    *   Se corrigieron errores de concordancia verbal.
    *   Se agregaron signos de puntuación donde era necesario.
    *   Se usaron negritas para resaltar nombres y cambios.
    *   Se corrigió el error de concordancia entre el nombre del programa y el apellido del conductor.